Player,Tm,Salary,Pos,Age,G,GS,MP,FG,FGA,FG%,3P,3PA,3P%,2P,2PA,2P%,eFG%,FT,FTA,FT%,ORB,DRB,TRB,AST,STL,BLK,TOV,PF,PTS
Stephen Curry,GSW,51915615.00,PG,34,56,56,1941,559,1133,0.493,273,639,0.427,286,494,0.579,0.614,257,281,0.915,39,302,341,352,52,20,179,117,1648
Kevin Durant,PHO,47649433.00,PF,34,8,8,269,73,128,0.57,22,41,0.537,51,87,0.586,0.656,40,48,0.833,3,48,51,28,2,10,20,7,208
Nikola Jokić,DEN,47607350.00,C,27,69,69,2323,646,1022,0.632,57,149,0.383,589,873,0.675,0.66,341,415,0.822,167,650,817,678,87,47,247,174,1690
Joel Embiid,PHI,47607350.00,C,28,66,66,2284,728,1328,0.548,66,200,0.33,662,1128,0.587,0.573,661,771,0.857,113,557,670,274,66,112,226,205,2183
LeBron James,LAL,47607350.00,PF,38,55,54,1954,609,1219,0.5,121,377,0.321,488,842,0.58,0.549,251,327,0.768,65,392,457,375,50,32,178,88,1590
Giannis Antetokounmpo,MIL,45640084.00,PF,28,63,63,2024,707,1278,0.553,47,171,0.275,660,1107,0.596,0.572,498,772,0.645,137,605,742,359,52,51,246,197,1959
Kawhi Leonard,LAC,45640084.00,SF,31,52,50,1748,446,871,0.512,104,250,0.416,342,621,0.551,0.572,243,279,0.871,57,281,338,204,72,28,88,84,1239
Paul George,LAC,45640084.00,SF,32,56,56,1939,459,1004,0.457,158,426,0.371,301,578,0.521,0.536,256,294,0.871,45,297,342,288,83,20,176,159,1332
Jimmy Butler,MIA,45183960.00,PF,33,64,64,2138,479,888,0.539,36,103,0.35,443,785,0.564,0.56,472,555,0.85,141,234,375,340,117,21,101,80,1466
Klay Thompson,GSW,43219440.00,SF,32,69,69,2279,546,1252,0.436,301,731,0.412,245,521,0.47,0.556,116,132,0.879,39,247,286,163,49,29,123,130,1509
Rudy Gobert,MIN,41000000.00,C,30,70,70,2148,360,546,0.659,0,3,0,360,543,0.663,0.659,219,340,0.644,231,583,814,87,56,95,122,210,939
Anthony Davis,LAL,40600080.00,C,29,56,54,1904,542,962,0.563,19,74,0.257,523,888,0.589,0.573,348,444,0.784,195,507,702,148,59,114,122,146,1451
Trae Young,ATL,40064220.00,PG,24,73,73,2541,597,1390,0.429,154,460,0.335,443,930,0.476,0.485,566,639,0.886,56,161,217,741,80,9,300,104,1914
Luka Dončić,DAL,40064220.00,PG,23,66,66,2391,719,1449,0.496,185,541,0.342,534,908,0.588,0.56,515,694,0.742,54,515,569,529,90,33,236,166,2138
Zach LaVine,CHI,40064220.00,SG,27,77,77,2768,673,1388,0.485,204,544,0.375,469,844,0.556,0.558,363,428,0.848,42,303,345,327,69,18,194,159,1913
Tobias Harris,PHI,39270150.00,SF,30,74,74,2436,423,845,0.501,126,324,0.389,297,521,0.57,0.575,113,129,0.876,67,357,424,186,68,40,89,149,1085
Ben Simmons,BRK,37893408.00,PG,26,42,33,1105,133,235,0.566,0,2,0,133,233,0.571,0.566,25,57,0.439,40,223,263,256,54,24,97,139,291
Pascal Siakam,TOR,37893408.00,PF,28,71,71,2652,630,1313,0.48,93,287,0.324,537,1026,0.523,0.515,367,474,0.774,131,425,556,415,65,36,169,228,1720
Kyrie Irving,DAL,37037037.00,SG,30,20,20,763,196,384,0.51,58,148,0.392,138,236,0.585,0.586,89,94,0.947,21,79,100,120,25,12,37,56,539
Devin Booker,PHO,36016200.00,SG,26,53,53,1835,527,1067,0.494,111,316,0.351,416,751,0.554,0.546,306,358,0.855,46,194,240,293,51,18,145,159,1471
Karl-Anthony Towns,MIN,36016200.00,PF,27,29,29,957,212,428,0.495,60,164,0.366,152,264,0.576,0.565,118,135,0.874,48,188,236,140,20,17,86,111,602
CJ McCollum,NOP,35802469.00,PG,31,75,75,2649,587,1344,0.437,211,543,0.389,376,801,0.469,0.515,183,238,0.769,55,273,328,429,70,38,183,153,1568
Zion Williamson,NOP,34005250.00,PF,22,29,29,956,285,469,0.608,7,19,0.368,278,450,0.618,0.615,177,248,0.714,58,144,202,133,32,16,99,65,754
Ja Morant,MEM,34005250.00,PG,23,61,59,1948,566,1214,0.466,92,300,0.307,474,914,0.519,0.504,372,497,0.748,61,296,357,493,66,16,206,100,1596
Darius Garland,CLE,34005250.00,PG,23,69,69,2447,522,1129,0.462,169,412,0.41,353,717,0.492,0.537,277,321,0.863,28,157,185,538,85,9,199,148,1490
Brandon Ingram,NOP,33833400.00,SF,25,45,45,1538,404,835,0.484,64,164,0.39,340,671,0.507,0.522,240,272,0.882,23,223,246,262,32,19,148,116,1112
Jamal Murray,DEN,33833400.00,PG,25,65,65,2133,473,1041,0.454,172,432,0.398,301,609,0.494,0.537,180,216,0.833,48,209,257,400,66,16,145,103,1298
Shai Gilgeous-Alexander,OKC,33386850.00,PG,24,68,68,2416,704,1381,0.51,58,168,0.345,646,1213,0.533,0.531,669,739,0.905,59,270,329,371,112,65,192,192,2135
Michael Porter Jr.,DEN,33386850.00,SF,24,62,62,1798,398,817,0.487,188,454,0.414,210,363,0.579,0.602,96,120,0.8,64,277,341,65,37,29,68,119,1080
Donovan Mitchell,CLE,33162030.00,SG,26,68,68,2432,679,1402,0.484,245,635,0.386,434,767,0.566,0.572,319,368,0.867,63,226,289,301,99,27,180,168,1922
De'Aaron Fox,SAC,32600060.00,PG,25,73,73,2435,682,1331,0.512,119,367,0.324,563,964,0.584,0.557,343,440,0.78,40,266,306,447,83,23,181,172,1826
Bam Adebayo,MIA,32600060.00,C,25,75,75,2598,602,1114,0.54,1,12,0.083,601,1102,0.545,0.541,324,402,0.806,184,504,688,240,88,61,187,208,1529
Jayson Tatum,BOS,32600060.00,SF,24,74,74,2732,727,1559,0.466,240,686,0.35,487,873,0.558,0.543,531,622,0.854,78,571,649,342,78,51,213,160,2225
Jaylen Brown,BOS,31830357.00,SF,26,67,67,2405,679,1383,0.491,163,487,0.335,516,896,0.576,0.55,263,344,0.765,78,381,459,232,75,26,197,172,1784
Gordon Hayward,CHO,31500000.00,SF,32,50,50,1577,276,581,0.475,52,160,0.325,224,421,0.532,0.52,129,159,0.811,33,182,215,206,42,12,99,70,733
Domantas Sabonis,SAC,30600000.00,C,26,79,79,2736,577,938,0.615,31,83,0.373,546,855,0.639,0.632,325,438,0.742,251,722,973,573,65,39,230,279,1510
Kyle Lowry,MIA,29682540.00,PG,36,55,44,1718,196,485,0.404,107,310,0.345,89,175,0.509,0.514,116,135,0.859,43,182,225,281,57,21,103,143,615
Khris Middleton,MIL,29320988.00,SF,31,33,19,801,177,406,0.436,51,162,0.315,126,244,0.516,0.499,92,102,0.902,28,112,140,163,23,5,71,68,497
DeMar DeRozan,CHI,28600000.00,SF,33,74,74,2682,657,1303,0.504,46,142,0.324,611,1161,0.526,0.522,456,523,0.872,34,309,343,377,83,36,153,186,1816
Julius Randle,NYK,28226880.00,PF,28,77,77,2737,658,1432,0.459,218,636,0.343,440,796,0.553,0.536,402,531,0.757,141,626,767,316,49,21,216,233,1936
Jerami Grant,POR,27586207.00,PF,28,63,63,2246,434,913,0.475,144,359,0.401,290,554,0.523,0.554,278,342,0.813,53,230,283,150,51,53,116,152,1290
Jaren Jackson Jr.,MEM,27102202.00,C,23,63,63,1787,416,822,0.506,100,282,0.355,316,540,0.585,0.567,241,306,0.788,108,318,426,60,65,189,107,227,1173
Tyler Herro,MIA,27000000.00,SG,23,67,67,2337,487,1109,0.439,203,537,0.378,284,572,0.497,0.531,170,182,0.934,27,333,360,280,51,16,158,101,1347
Jalen Brunson,NYK,26346666.00,PG,26,68,68,2379,587,1195,0.491,134,322,0.416,453,873,0.519,0.547,325,392,0.829,40,201,241,421,61,15,142,152,1633
Cameron Johnson,BRK,25679348.00,PF,26,25,25,770,141,301,0.468,58,156,0.372,83,145,0.572,0.565,74,87,0.851,20,100,120,52,35,8,27,54,414
Kyle Kuzma,WAS,25568182.00,PF,27,64,64,2239,512,1142,0.448,160,481,0.333,352,661,0.533,0.518,173,237,0.73,55,408,463,239,36,29,190,145,1357
Brook Lopez,MIL,25000000.00,C,34,78,78,2373,477,899,0.531,136,364,0.374,341,535,0.637,0.606,149,190,0.784,157,363,520,99,37,193,107,203,1239
Mike Conley,MIN,24360000.00,PG,35,24,24,753,108,235,0.46,58,138,0.42,50,97,0.515,0.583,63,73,0.863,16,59,75,120,29,4,29,45,337
Andrew Wiggins,GSW,24330357.00,SF,27,37,37,1190,250,529,0.473,89,225,0.396,161,304,0.53,0.557,44,72,0.611,61,125,186,85,45,28,48,107,633
Anfernee Simons,POR,24107143.00,SG,23,62,62,2171,467,1045,0.447,212,562,0.377,255,483,0.528,0.548,160,179,0.894,18,143,161,253,42,14,128,142,1306
RJ Barrett,NYK,23883929.00,SG,22,73,73,2475,510,1176,0.434,121,390,0.31,389,786,0.495,0.485,290,392,0.74,60,308,368,201,31,15,164,179,1431
Jordan Clarkson,UTA,23487629.00,SG,30,61,61,1988,458,1031,0.444,155,459,0.338,303,572,0.53,0.519,200,245,0.816,72,174,246,270,33,13,186,120,1271
Terry Rozier,CHO,23205221.00,SG,28,63,63,2221,493,1188,0.415,165,505,0.327,328,683,0.48,0.484,178,220,0.809,51,208,259,319,74,16,134,119,1329
Draymond Green,GSW,22321429.00,PF,32,73,73,2297,250,474,0.527,40,131,0.305,210,343,0.612,0.57,77,108,0.713,66,459,525,500,74,60,204,229,617
Aaron Gordon,DEN,22266182.00,PF,27,68,68,2055,429,761,0.564,60,173,0.347,369,588,0.628,0.603,191,314,0.608,164,282,446,203,54,51,98,129,1109
Mikal Bridges,BRK,21700000.00,SG,26,27,27,923,239,503,0.475,68,181,0.376,171,322,0.531,0.543,160,179,0.894,23,98,121,72,26,16,49,44,706
Myles Turner,IND,20975000.00,C,26,62,62,1825,402,733,0.548,93,249,0.373,309,484,0.638,0.612,216,276,0.783,88,378,466,89,36,140,103,215,1113
Clint Capela,ATL,20616000.00,C,28,65,63,1730,350,536,0.653,0,1,0,350,535,0.654,0.653,79,131,0.603,258,459,717,58,45,79,54,139,779
Spencer Dinwiddie,BRK,20357143.00,PG,29,26,26,917,144,356,0.404,43,149,0.289,101,207,0.488,0.465,98,123,0.797,9,98,107,236,28,8,55,63,429
De'Andre Hunter,ATL,20089286.00,SF,25,67,67,2126,379,822,0.461,100,286,0.35,279,536,0.521,0.522,171,207,0.826,46,238,284,94,35,17,82,199,1029
Keldon Johnson,SAS,20000000.00,SF,23,63,63,2063,503,1113,0.452,134,407,0.329,369,706,0.523,0.512,245,327,0.749,56,262,318,183,46,11,134,125,1385
Jarrett Allen,CLE,20000000.00,C,24,68,68,2220,403,626,0.644,1,10,0.1,402,616,0.653,0.645,162,221,0.733,221,445,666,113,54,84,93,153,969
Bojan Bogdanović,DET,20000000.00,PF,33,59,59,1893,430,882,0.488,145,353,0.411,285,529,0.539,0.57,268,303,0.884,36,187,223,152,34,8,135,113,1273
Jakob Poeltl,TOR,19500000.00,C,27,26,25,707,150,230,0.652,0,0,,150,230,0.652,0.652,41,72,0.569,84,153,237,56,30,34,29,77,341
Buddy Hield,IND,19279841.00,SF,30,80,73,2482,475,1038,0.458,288,677,0.425,187,361,0.518,0.596,106,129,0.822,67,333,400,225,92,26,139,156,1344
Evan Fournier,NYK,18857143.00,SG,30,27,7,459,56,166,0.337,35,114,0.307,21,52,0.404,0.443,18,21,0.857,4,45,49,36,16,3,22,46,165
Bogdan Bogdanović,ATL,18700000.00,SG,30,54,9,1508,273,611,0.447,146,360,0.406,127,251,0.506,0.566,64,77,0.831,23,142,165,150,43,18,65,86,756
OG Anunoby,TOR,18642857.00,SF,25,67,67,2386,421,885,0.476,142,367,0.387,279,518,0.539,0.556,140,167,0.838,95,237,332,131,128,50,132,200,1124
Gary Trent Jr.,TOR,18560000.00,SG,24,66,44,2118,405,935,0.433,166,450,0.369,239,485,0.493,0.522,172,205,0.839,30,143,173,106,104,14,55,102,1148
Nikola Vučević,CHI,18518519.00,C,32,82,82,2746,597,1148,0.52,121,347,0.349,476,801,0.594,0.573,132,158,0.835,159,744,903,265,60,57,139,179,1447
Derrick White,BOS,18357143.00,SG,28,82,70,2319,350,758,0.462,149,391,0.381,201,367,0.548,0.56,168,192,0.875,52,241,293,321,54,76,95,177,1017
Dejounte Murray,ATL,18214000.00,SG,26,74,74,2693,612,1319,0.464,133,387,0.344,479,932,0.514,0.514,158,190,0.832,53,336,389,448,112,19,160,106,1515
Duncan Robinson,MIA,18154000.00,SF,28,42,1,691,88,237,0.371,63,192,0.328,25,45,0.556,0.504,29,32,0.906,8,61,69,46,14,0,28,77,268
Norman Powell,LAC,18000000.00,SG,29,60,8,1567,340,710,0.479,114,287,0.397,226,423,0.534,0.559,225,277,0.812,24,151,175,109,50,18,101,125,1019
Tim Hardaway Jr.,DAL,17897728.00,SF,30,71,45,2152,340,847,0.401,212,550,0.385,128,297,0.431,0.527,127,165,0.77,21,230,251,129,49,12,60,120,1019
Jonathan Isaac,ORL,17400000.00,PF,25,11,0,124,22,53,0.415,6,15,0.4,16,38,0.421,0.472,5,9,0.556,15,29,44,6,14,4,4,5,55
Collin Sexton,UTA,17325000.00,PG,24,48,15,1145,237,468,0.506,48,122,0.393,189,346,0.546,0.558,163,199,0.819,37,68,105,138,27,6,85,112,685
D'Angelo Russell,LAL,17307693.00,PG,26,17,17,526,107,221,0.484,46,111,0.414,61,110,0.555,0.588,36,49,0.735,7,43,50,103,10,8,39,23,296
Lauri Markkanen,UTA,17259999.00,PF,25,66,66,2273,571,1145,0.499,200,511,0.391,371,634,0.585,0.586,349,399,0.875,130,440,570,123,42,38,127,137,1691
Harrison Barnes,SAC,17000000.00,PF,30,82,82,2662,374,791,0.473,132,353,0.374,242,438,0.553,0.556,350,413,0.847,87,279,366,128,57,10,86,103,1230
Markelle Fultz,ORL,17000000.00,PG,24,60,60,1778,349,679,0.514,27,87,0.31,322,592,0.544,0.534,112,143,0.783,69,165,234,341,87,26,139,131,837
P.J. Washington,CHO,16847826.00,PF,24,73,73,2380,434,978,0.444,149,428,0.348,285,550,0.518,0.52,127,174,0.73,73,285,358,175,66,79,110,193,1144
Rui Hachimura,LAL,15740741.00,PF,24,33,9,738,126,260,0.485,21,71,0.296,105,189,0.556,0.525,44,61,0.721,34,121,155,23,8,14,17,33,317
Mitchell Robinson,NYK,15681818.00,C,24,59,58,1591,188,280,0.671,0,0,,188,280,0.671,0.671,59,122,0.484,267,288,555,53,56,109,41,160,435
Kevin Huerter,SAC,15669643.00,SG,24,75,75,2203,420,866,0.485,205,510,0.402,215,356,0.604,0.603,95,131,0.725,42,209,251,221,80,24,97,181,1140
Jonas Valančiūnas,NOP,15435000.00,C,30,79,79,1968,446,816,0.547,38,109,0.349,408,707,0.577,0.57,185,224,0.826,225,579,804,140,20,52,159,245,1115
Caris LeVert,CLE,15384616.00,SG,28,74,30,2237,320,742,0.431,127,324,0.392,193,418,0.462,0.517,130,180,0.722,53,229,282,287,72,24,116,170,897
Luguentz Dort,OKC,15277778.00,SF,23,74,73,2272,339,873,0.388,135,409,0.33,204,464,0.44,0.466,200,259,0.772,128,216,344,154,75,23,92,243,1013
Luke Kennard,MEM,14763636.00,SG,26,24,3,590,90,171,0.526,74,137,0.54,16,34,0.471,0.743,18,19,0.947,9,66,75,54,13,1,16,35,272
Kentavious Caldwell-Pope,DEN,14704938.00,SG,29,76,76,2381,292,632,0.462,135,319,0.423,157,313,0.502,0.569,103,125,0.824,35,173,208,183,112,35,86,145,822
Dorian Finney-Smith,BRK,13932008.00,PF,29,26,26,721,67,191,0.351,37,121,0.306,30,70,0.429,0.448,15,19,0.789,47,81,128,41,17,16,26,64,186
Doug McDermott,SAS,13750000.00,SF,31,64,0,1314,239,523,0.457,123,298,0.413,116,225,0.516,0.575,53,70,0.757,24,115,139,91,13,6,58,118,654
Anthony Edwards,MIN,13534817.00,SG,21,79,79,2842,707,1541,0.459,213,578,0.369,494,963,0.513,0.528,319,422,0.756,47,411,458,350,125,58,259,186,1946
Wendell Carter Jr.,ORL,13050000.00,C,23,57,54,1690,322,613,0.525,80,225,0.356,242,388,0.624,0.591,144,195,0.738,120,377,497,132,30,33,106,159,868
Gary Harris,ORL,13000000.00,SG,28,48,42,1184,138,307,0.45,94,218,0.431,44,89,0.494,0.603,27,30,0.9,21,77,98,59,45,12,28,93,397
Josh Hart,NYK,12960000.00,SF,27,25,1,750,92,157,0.586,27,52,0.519,65,105,0.619,0.672,45,57,0.789,47,129,176,90,34,12,38,62,256
Naz Reid,MIN,12950400.00,C,23,68,11,1251,310,577,0.537,75,217,0.346,235,360,0.653,0.602,86,127,0.677,73,260,333,77,42,53,92,176,781
Steven Adams,MEM,12600000.00,C,29,42,42,1133,157,263,0.597,0,1,0,157,262,0.599,0.597,47,129,0.364,214,271,485,97,36,46,79,98,361
Brandon Clarke,MEM,12500000.00,PF,26,56,8,1090,229,349,0.656,1,6,0.167,228,343,0.665,0.658,99,137,0.723,92,218,310,72,34,37,55,131,558
Marvin Bagley III,DET,12500000.00,C,23,42,25,990,202,382,0.529,19,66,0.288,183,316,0.579,0.554,81,108,0.75,94,175,269,36,19,30,46,81,504
Daniel Gafford,WAS,12402000.00,C,24,78,47,1604,289,395,0.732,0,0,,289,395,0.732,0.732,127,187,0.679,163,270,433,84,33,99,85,187,705
Kelly Olynyk,UTA,12195122.00,C,31,68,68,1942,278,557,0.499,93,236,0.394,185,321,0.576,0.583,198,232,0.853,82,338,420,252,60,37,168,232,847
James Wiseman,DET,12119440.00,C,21,24,22,605,130,245,0.531,3,18,0.167,127,227,0.559,0.537,42,59,0.712,55,139,194,16,4,20,37,69,305
Devonte' Graham,SAS,12100000.00,PG,27,20,8,527,76,200,0.38,53,148,0.358,23,52,0.442,0.513,54,72,0.75,7,43,50,80,15,6,26,31,259
Herbert Jones,NOP,12015150.00,PF,24,66,66,1951,235,501,0.469,56,167,0.335,179,334,0.536,0.525,123,161,0.764,97,172,269,162,103,42,88,208,649
Austin Reaves,LAL,12015150.00,SG,24,64,22,1843,259,490,0.529,86,216,0.398,173,274,0.631,0.616,229,265,0.864,33,160,193,215,33,19,99,108,833
Chris Boucher,TOR,11750000.00,PF,30,76,0,1523,261,529,0.493,62,189,0.328,199,340,0.585,0.552,128,168,0.762,157,264,421,29,47,64,41,143,712
Bobby Portis,MIL,11710818.00,PF,27,70,22,1818,398,803,0.496,95,257,0.37,303,546,0.555,0.555,96,125,0.768,154,518,672,105,29,16,81,115,987
Paolo Banchero,ORL,11608080.00,PF,20,72,72,2430,479,1122,0.427,85,285,0.298,394,837,0.471,0.465,394,534,0.738,84,413,497,269,60,39,200,160,1437
Coby White,CHI,11111111.00,SG,22,74,2,1730,263,594,0.443,128,344,0.372,135,250,0.54,0.551,61,70,0.871,16,196,212,204,54,6,74,122,715
Cade Cunningham,DET,11055360.00,PG,21,12,12,400,93,224,0.415,17,61,0.279,76,163,0.466,0.453,36,43,0.837,12,62,74,72,10,7,39,34,239
Talen Horton-Tucker,UTA,11020000.00,SG,22,65,20,1313,257,613,0.419,58,203,0.286,199,410,0.485,0.467,126,168,0.75,41,169,210,246,41,29,126,108,698
Maxi Kleber,DAL,11000000.00,PF,31,37,5,930,77,169,0.456,39,112,0.348,38,57,0.667,0.571,27,38,0.711,30,105,135,52,12,30,27,85,220
Ivica Zubac,LAC,10933333.00,C,25,76,76,2170,326,514,0.634,0,2,0,326,512,0.637,0.634,166,238,0.697,236,520,756,77,29,98,117,219,818
LaMelo Ball,CHO,10900635.00,PG,21,36,36,1268,296,721,0.411,144,383,0.376,152,338,0.45,0.51,102,122,0.836,42,189,231,304,46,11,129,118,838
Terance Mann,LAC,10576923.00,SG,26,81,36,1872,272,524,0.519,77,198,0.389,195,326,0.598,0.593,92,118,0.78,77,199,276,184,42,22,80,149,713
Matisse Thybulle,POR,10500000.00,SG,25,22,22,609,60,137,0.438,33,85,0.388,27,52,0.519,0.558,10,16,0.625,20,57,77,30,38,18,16,48,163
Alec Burks,DET,10489600.00,SG,31,51,8,1122,200,459,0.436,99,239,0.414,101,220,0.459,0.544,153,188,0.814,19,139,158,114,38,8,58,98,652
Larry Nance Jr.,NOP,10375000.00,C,30,65,1,1381,186,305,0.61,14,42,0.333,172,263,0.654,0.633,55,79,0.696,106,248,354,119,56,37,42,133,441
Al Horford,BOS,10000000.00,C,36,63,63,1922,228,479,0.476,145,325,0.446,83,154,0.539,0.627,15,21,0.714,73,317,390,189,30,61,37,121,616
Malik Monk,SAC,9945830.00,SG,24,77,0,1719,357,796,0.448,143,398,0.359,214,398,0.538,0.538,184,207,0.889,32,171,203,298,49,20,146,125,1041
Tre Jones,SAS,9895833.00,PG,23,68,65,1984,341,743,0.459,45,158,0.285,296,585,0.506,0.489,148,172,0.86,56,189,245,448,89,9,110,98,875
Jalen Green,HOU,9891480.00,SG,20,76,76,2602,566,1359,0.416,187,554,0.338,379,805,0.471,0.485,364,463,0.786,43,241,284,281,59,18,200,131,1683
Patrick Williams,CHI,9835881.00,PF,21,82,65,2323,314,677,0.464,115,277,0.415,199,400,0.498,0.549,90,105,0.857,78,249,327,100,72,70,101,147,833
Nic Claxton,BRK,9625000.00,C,23,76,76,2271,414,587,0.705,0,2,0,414,585,0.708,0.705,133,246,0.541,184,518,702,144,65,189,96,212,961
Royce O'Neale,BRK,9500000.00,SF,29,76,53,2409,229,593,0.386,163,419,0.389,66,174,0.379,0.524,50,69,0.725,55,329,384,283,65,49,114,239,671
Alex Caruso,CHI,9460000.00,PG,28,67,36,1575,130,286,0.455,55,151,0.364,75,135,0.556,0.551,59,73,0.808,42,154,196,193,98,46,77,159,374
Pat Connaughton,MIL,9423869.00,SF,30,61,33,1443,165,421,0.392,109,322,0.339,56,99,0.566,0.521,27,41,0.659,50,233,283,77,37,11,33,69,466
Jabari Smith Jr.,HOU,9326520.00,PF,19,79,79,2451,364,892,0.408,120,391,0.307,244,501,0.487,0.475,162,206,0.786,122,447,569,101,43,74,104,227,1010
Isaiah Hartenstein,NYK,9245121.00,C,24,82,8,1626,175,327,0.535,8,37,0.216,167,290,0.576,0.547,48,71,0.676,209,327,536,102,53,64,66,213,406
Kyle Anderson,MIN,9219512.00,PF,29,69,46,1957,252,495,0.509,43,105,0.41,209,390,0.536,0.553,100,136,0.735,66,302,368,335,78,63,103,146,647
Isaac Okoro,CLE,8920795.00,SF,22,76,46,1652,175,354,0.494,62,171,0.363,113,183,0.617,0.582,78,103,0.757,52,135,187,87,56,30,42,158,490
Evan Mobley,CLE,8882640.00,PF,21,79,79,2715,525,947,0.554,22,102,0.216,503,845,0.595,0.566,205,304,0.674,187,524,711,224,60,119,146,218,1277
Gary Payton II,GSW,8715000.00,SG,30,7,0,112,17,28,0.607,4,9,0.444,13,19,0.684,0.679,2,3,0.667,14,16,30,8,6,4,4,14,40
T.J. McConnell,IND,8700000.00,PG,30,75,6,1526,283,521,0.543,26,59,0.441,257,462,0.556,0.568,58,68,0.853,45,189,234,397,81,10,143,105,650
Keegan Murray,SAC,8409000.00,SF,22,80,78,2382,354,782,0.453,206,501,0.411,148,281,0.527,0.584,62,81,0.765,89,282,371,98,61,42,60,162,976
Delon Wright,WAS,8195122.00,PG,30,50,14,1221,138,291,0.474,41,119,0.345,97,172,0.564,0.545,52,60,0.867,58,122,180,194,92,17,44,59,369
Onyeka Okongwu,ATL,8109063.00,C,22,80,18,1849,317,497,0.638,4,13,0.308,313,484,0.647,0.642,153,196,0.781,217,359,576,81,56,107,81,251,791
Scottie Barnes,TOR,8008680.00,SF,21,77,76,2678,463,1016,0.456,63,224,0.281,400,792,0.505,0.487,190,246,0.772,179,333,512,371,83,61,154,170,1179
Trey Lyles,SAC,8000000.00,PF,27,74,0,1247,187,408,0.458,87,240,0.363,100,168,0.595,0.565,101,124,0.815,68,232,300,66,27,31,64,97,562
De'Anthony Melton,PHI,8000000.00,SG,24,77,58,2150,277,651,0.425,157,403,0.39,120,248,0.484,0.546,69,87,0.793,69,243,312,197,126,41,102,191,780
Moritz Wagner,ORL,8000000.00,C,25,57,18,1109,198,396,0.5,51,163,0.313,147,233,0.631,0.564,153,182,0.841,69,190,259,84,37,13,68,136,600
Thaddeus Young,TOR,8000000.00,PF,34,54,9,795,108,198,0.545,6,34,0.176,102,164,0.622,0.561,18,26,0.692,71,95,166,75,54,5,42,88,240
Paul Reed,PHI,7723000.00,C,23,69,2,755,124,209,0.593,1,6,0.167,123,203,0.606,0.596,38,51,0.745,112,150,262,27,46,51,45,123,287
Zach Collins,SAS,7700000.00,C,25,63,26,1441,284,548,0.518,55,147,0.374,229,401,0.571,0.568,108,142,0.761,116,286,402,180,37,49,129,199,731
Jaden Ivey,DET,7614480.00,SG,20,74,73,2304,409,983,0.416,120,350,0.343,289,633,0.457,0.477,266,356,0.747,73,215,288,387,61,17,237,242,1204
Cody Martin,CHO,7560000.00,SF,27,7,0,134,14,36,0.389,3,14,0.214,11,22,0.5,0.431,4,7,0.571,8,16,24,11,4,1,2,13,35
Kevon Looney,GSW,7500000.00,C,26,82,70,1958,242,384,0.63,0,1,0,242,383,0.632,0.63,94,155,0.606,274,486,760,207,52,50,45,225,578
Killian Hayes,DET,7413955.00,PG,21,76,56,2154,307,815,0.377,80,286,0.28,227,529,0.429,0.426,92,112,0.821,28,193,221,470,104,28,173,219,786
Jalen Suggs,ORL,7252080.00,SG,21,53,19,1246,186,444,0.419,66,202,0.327,120,242,0.496,0.493,86,119,0.723,55,106,161,155,67,27,94,120,524
Daniel Theis,IND,6928876.00,C,30,7,1,109,21,44,0.477,2,11,0.182,19,33,0.576,0.5,5,12,0.417,7,15,22,9,2,6,3,7,49
Bennedict Mathurin,IND,6916080.00,SG,20,78,17,2222,413,951,0.434,100,310,0.323,313,641,0.488,0.487,376,454,0.828,87,231,318,116,48,13,152,162,1302
Caleb Martin,MIA,6802950.00,SF,27,71,49,2077,254,548,0.464,84,236,0.356,170,312,0.545,0.54,91,113,0.805,88,256,344,117,71,31,78,145,683
Josh Giddey,OKC,6587040.00,PF,20,76,76,2367,539,1118,0.482,76,234,0.325,463,884,0.524,0.516,106,145,0.731,148,451,599,469,57,31,211,143,1260
Jae'Sean Tate,HOU,6500000.00,SF,27,31,7,677,110,229,0.48,13,46,0.283,97,183,0.53,0.509,50,69,0.725,41,77,118,84,21,7,47,106,283
Ayo Dosunmu,CHI,6481482.00,SG,23,80,51,2098,281,570,0.493,59,189,0.312,222,381,0.583,0.545,66,82,0.805,45,175,220,206,62,26,99,182,687
Shaedon Sharpe,POR,6313800.00,SG,19,80,15,1779,306,648,0.472,102,283,0.36,204,365,0.559,0.551,75,105,0.714,63,173,236,94,38,24,83,136,789
Otto Porter Jr.,TOR,6300000.00,SF,29,8,2,146,15,30,0.5,6,17,0.353,9,13,0.692,0.6,8,8,1,6,13,19,8,11,0,4,7,44
Deni Avdija,WAS,6263188.00,SF,22,76,40,2020,253,579,0.437,69,232,0.297,184,347,0.53,0.497,122,165,0.739,74,413,487,211,65,29,123,209,697
Kenrich Williams,OKC,6175000.00,PF,28,53,10,1206,179,346,0.517,50,134,0.373,129,212,0.608,0.59,17,39,0.436,97,164,261,105,45,14,32,112,425
Ricky Rubio,CLE,6146342.00,PG,32,33,2,566,61,178,0.343,21,82,0.256,40,96,0.417,0.402,28,35,0.8,9,61,70,115,26,6,31,51,171
Jonathan Kuminga,GSW,6012840.00,PF,20,67,16,1394,261,497,0.525,54,146,0.37,207,351,0.59,0.579,90,138,0.652,70,161,231,125,41,31,95,157,666
Devin Vassell,SAS,5887899.00,SG,22,38,32,1178,261,595,0.439,103,266,0.387,158,329,0.48,0.525,78,100,0.78,8,140,148,136,43,17,57,57,703
Tyrese Haliburton,IND,5808435.00,PG,22,56,56,1883,412,841,0.49,161,402,0.4,251,439,0.572,0.586,175,201,0.871,33,172,205,585,91,25,141,69,1160
Dyson Daniels,NOP,5784120.00,PG,19,59,11,1042,87,208,0.418,27,86,0.314,60,122,0.492,0.483,26,40,0.65,36,152,188,134,43,11,57,99,227
Kira Lewis Jr.,NOP,5722116.00,PG,21,25,0,235,40,88,0.455,15,34,0.441,25,54,0.463,0.54,19,22,0.864,5,28,33,23,10,2,10,24,114
Dean Wade,CLE,5709877.00,PF,26,44,13,891,73,177,0.412,45,127,0.354,28,50,0.56,0.54,15,23,0.652,20,130,150,37,28,21,17,89,206
Aaron Nesmith,IND,5634257.00,SF,23,73,60,1816,252,590,0.427,115,314,0.366,137,276,0.496,0.525,119,142,0.838,62,215,277,98,55,34,75,235,738
Cole Anthony,ORL,5539771.00,PG,22,60,4,1552,277,610,0.454,75,206,0.364,202,404,0.5,0.516,152,170,0.894,47,241,288,235,37,31,91,158,781
Franz Wagner,ORL,5508720.00,SF,21,80,80,2609,542,1118,0.485,130,360,0.361,412,758,0.544,0.543,271,322,0.842,70,259,329,283,77,17,167,183,1485
Furkan Korkmaz,PHI,5370370.00,SG,25,37,0,353,48,111,0.432,18,46,0.391,30,65,0.462,0.514,26,36,0.722,6,36,42,22,10,3,24,18,140
Jeremy Sochan,SAS,5316960.00,PF,19,56,53,1458,250,552,0.453,33,134,0.246,217,418,0.519,0.483,81,116,0.698,95,200,295,142,43,23,97,138,614
Isaiah Stewart,DET,5266713.00,C,21,50,47,1414,195,441,0.442,67,205,0.327,128,236,0.542,0.518,110,149,0.738,115,288,403,70,20,34,68,133,567
Chuma Okeke,ORL,5266713.00,SF,24,27,8,518,43,122,0.352,26,86,0.302,17,36,0.472,0.459,16,21,0.762,26,70,96,37,19,11,17,40,128
Davion Mitchell,SAC,5063640.00,PG,24,80,9,1447,181,399,0.454,63,197,0.32,118,202,0.584,0.533,25,31,0.806,16,89,105,185,44,15,62,112,450
Johnny Davis,WAS,5050800.00,SG,20,28,5,423,66,171,0.386,17,70,0.243,49,101,0.485,0.436,14,27,0.519,10,55,65,28,10,8,17,48,163
Jalen Smith,IND,5043773.00,C,22,68,31,1279,242,508,0.476,54,191,0.283,188,317,0.593,0.53,104,137,0.759,129,265,394,66,21,60,72,153,642
Aleksej Pokusevski,OKC,5009633.00,PF,21,34,25,701,108,249,0.434,38,104,0.365,70,145,0.483,0.51,22,35,0.629,45,114,159,64,20,43,43,58,276
Nick Richards,CHO,5000000.00,C,25,65,9,1217,197,313,0.629,1,1,1,196,312,0.628,0.631,137,183,0.749,147,269,416,38,11,71,59,154,532
Mason Plumlee,LAC,5000000.00,C,32,23,4,457,64,88,0.727,0,0,,64,88,0.727,0.727,44,57,0.772,42,117,159,40,11,12,30,56,172
Reggie Jackson,DEN,5000000.00,PG,32,16,2,319,49,128,0.383,19,68,0.279,30,60,0.5,0.457,10,12,0.833,3,25,28,50,9,1,19,22,127
Ziaire Williams,MEM,4810200.00,SF,21,37,4,561,84,196,0.429,25,97,0.258,59,99,0.596,0.492,17,22,0.773,16,63,79,35,14,6,37,58,210
Ousmane Dieng,OKC,4798440.00,PF,19,39,1,569,76,181,0.42,26,98,0.265,50,83,0.602,0.492,15,23,0.652,19,86,105,46,14,7,26,42,193
Josh Green,DAL,4765339.00,SG,22,60,21,1539,205,382,0.537,68,169,0.402,137,213,0.643,0.626,68,94,0.723,55,127,182,103,42,5,72,156,546
Jarred Vanderbilt,LAL,4698000.00,PF,23,26,24,625,74,140,0.529,10,33,0.303,64,107,0.598,0.564,29,37,0.784,49,124,173,42,30,6,29,57,187
Nickeil Alexander-Walker,MIN,4687500.00,SG,24,23,0,356,48,125,0.384,26,72,0.361,22,53,0.415,0.488,13,21,0.619,7,35,42,32,8,7,10,30,135
James Bouknight,CHO,4570080.00,SG,22,34,0,515,69,193,0.358,33,109,0.303,36,84,0.429,0.443,20,30,0.667,8,64,72,41,14,5,32,49,191
Jalen Williams,OKC,4558680.00,SG,21,75,62,2276,414,794,0.521,73,205,0.356,341,589,0.579,0.567,155,191,0.812,84,253,337,248,103,35,123,191,1056
Saddiq Bey,ATL,4556983.00,SF,23,25,7,629,108,230,0.47,50,125,0.4,58,105,0.552,0.578,25,29,0.862,39,81,120,34,20,1,17,37,291
Precious Achiuwa,TOR,4379527.00,C,23,55,12,1140,196,404,0.485,29,108,0.269,167,296,0.564,0.521,87,124,0.702,100,228,328,50,31,30,59,102,508
Tyrese Maxey,PHI,4343920.00,SG,22,60,41,2016,439,913,0.481,160,369,0.434,279,544,0.513,0.568,180,213,0.845,23,153,176,212,49,8,80,132,1218
Joshua Primo,SAS,4341600.00,SG,20,4,0,93,9,26,0.346,3,12,0.25,6,14,0.429,0.404,7,9,0.778,2,11,13,18,1,2,11,8,28
Jalen Duren,DET,4330680.00,C,19,67,31,1670,258,398,0.648,0,2,0,258,396,0.652,0.648,96,157,0.611,229,366,595,75,44,59,92,182,612
Danuel House Jr.,PHI,4310250.00,SF,29,56,5,807,93,197,0.472,37,110,0.336,56,87,0.644,0.566,45,60,0.75,9,85,94,44,14,9,26,69,268
Zeke Nnaji,DEN,4306281.00,PF,22,53,5,728,110,196,0.561,17,65,0.262,93,131,0.71,0.605,40,62,0.645,65,73,138,18,17,23,31,105,277
Immanuel Quickley,NYK,4171548.00,SG,23,81,21,2344,419,936,0.448,168,454,0.37,251,482,0.521,0.537,203,248,0.819,58,279,337,279,80,14,100,166,1209
Ochai Agbaji,UTA,4114200.00,SG,22,59,22,1209,165,386,0.427,81,228,0.355,84,158,0.532,0.532,56,69,0.812,43,78,121,67,16,15,41,99,467
Payton Pritchard,BOS,4037277.00,PG,25,48,3,643,101,245,0.412,56,154,0.364,45,91,0.495,0.527,12,16,0.75,25,63,88,64,14,1,40,37,270
Dwight Powell,DAL,4000000.00,C,31,76,64,1458,197,269,0.732,0,5,0,197,264,0.746,0.732,112,168,0.667,149,165,314,69,48,26,65,209,506
Moses Moody,GSW,3918480.00,SG,20,63,3,817,108,227,0.476,49,135,0.363,59,92,0.641,0.584,37,53,0.698,28,77,105,51,18,7,34,54,302
Mark Williams,CHO,3908160.00,C,21,43,17,828,160,251,0.637,0,0,,160,251,0.637,0.637,67,97,0.691,93,211,304,18,28,45,40,94,387
Jaden McDaniels,MIN,3901399.00,SF,22,79,79,2416,370,716,0.517,107,269,0.398,263,447,0.588,0.591,106,144,0.736,92,215,307,148,74,76,112,272,953
Malachi Flynn,TOR,3873025.00,PG,24,53,2,691,87,242,0.36,47,133,0.353,40,109,0.367,0.457,25,33,0.758,15,61,76,70,21,4,25,65,246
Desmond Bane,MEM,3845083.00,SG,24,58,58,1841,450,939,0.479,166,407,0.408,284,532,0.534,0.568,181,205,0.883,43,248,291,254,56,22,126,150,1247
Russell Westbrook,LAC,3835738.00,PG,34,21,21,635,128,262,0.489,26,73,0.356,102,189,0.54,0.538,50,76,0.658,30,72,102,160,23,10,71,41,332
Kevin Love,MIA,3835738.00,PF,34,21,17,419,54,139,0.388,30,101,0.297,24,38,0.632,0.496,24,28,0.857,17,102,119,40,9,5,23,32,162
Corey Kispert,WAS,3722040.00,SF,23,74,45,2093,291,585,0.497,163,384,0.424,128,201,0.637,0.637,75,88,0.852,33,174,207,87,32,9,55,97,820
AJ Griffin,ATL,3712920.00,SF,19,72,12,1401,248,533,0.465,101,259,0.39,147,274,0.536,0.56,42,47,0.894,37,116,153,73,42,12,42,87,639
Amir Coffey,LAC,3666667.00,SF,25,50,9,625,56,145,0.386,11,40,0.275,45,105,0.429,0.424,49,63,0.778,17,36,53,53,7,5,21,50,172
Alperen Şengün,HOU,3536280.00,C,20,75,72,2171,442,799,0.553,19,57,0.333,423,742,0.57,0.565,206,288,0.715,242,436,678,291,70,70,193,258,1109
Tari Eason,HOU,3527160.00,PF,21,82,5,1767,296,660,0.448,59,172,0.343,237,488,0.486,0.493,109,145,0.752,195,301,496,88,96,47,101,189,760
Andre Drummond,CHI,3360000.00,C,29,67,0,849,166,274,0.606,0,3,0,166,271,0.613,0.606,67,125,0.536,138,306,444,33,45,27,75,117,399
Derrick Jones Jr.,CHI,5379706.00,PF,25,64,0,893,115,230,0.5,27,80,0.338,88,150,0.587,0.559,62,84,0.738,60,93,153,34,29,37,25,86,319
Trey Murphy III,NOP,3359280.00,SF,22,79,65,2448,387,800,0.484,202,497,0.406,185,303,0.611,0.61,172,190,0.905,59,222,281,112,89,43,61,155,1148
Dalen Terry,CHI,3350760.00,SG,20,38,0,214,32,72,0.444,7,27,0.259,25,45,0.556,0.493,14,21,0.667,12,25,37,22,11,5,8,24,85
Jake LaRavia,MEM,3199920.00,PF,21,35,0,414,37,95,0.389,24,71,0.338,13,24,0.542,0.516,7,9,0.778,19,44,63,21,12,4,18,49,105
Tre Mann,OKC,3191400.00,PG,21,67,5,1183,197,501,0.393,81,257,0.315,116,244,0.475,0.474,42,55,0.764,27,128,155,120,40,11,62,99,517
Malaki Branham,SAS,3071880.00,SG,19,66,32,1550,269,611,0.44,77,255,0.302,192,356,0.539,0.503,58,70,0.829,28,153,181,127,33,7,76,115,673
Kai Jones,CHO,3047880.00,C,22,46,0,550,67,120,0.558,4,19,0.211,63,101,0.624,0.575,19,26,0.731,37,86,123,15,17,30,31,65,157
Simone Fontecchio,UTA,3044872.00,SF,27,52,6,766,115,312,0.369,63,191,0.33,52,121,0.43,0.47,35,44,0.795,31,55,86,42,15,8,39,62,328
Julian Champagnie,SAS,3000000.00,SF,21,15,3,313,59,128,0.461,33,81,0.407,26,47,0.553,0.59,14,17,0.824,10,50,60,10,5,5,11,26,165
Jordan Nwora,IND,3000000.00,SF,24,24,11,591,118,248,0.476,46,109,0.422,72,139,0.518,0.569,31,43,0.721,22,90,112,50,12,7,32,40,313
Christian Braun,DEN,2949120.00,SG,21,76,6,1181,143,289,0.495,34,96,0.354,109,193,0.565,0.554,40,64,0.625,48,133,181,59,41,17,35,101,360
Jalen Johnson,ATL,2925360.00,SF,21,70,6,1042,158,322,0.491,30,104,0.288,128,218,0.587,0.537,49,78,0.628,51,231,282,83,38,34,41,113,395
Walker Kessler,UTA,2831160.00,C,21,74,40,1703,298,414,0.72,1,3,0.333,297,411,0.723,0.721,82,159,0.516,231,389,620,69,26,173,58,169,679
Josh Okogie,PHO,2815937.00,SG,24,72,26,1350,162,414,0.391,66,197,0.335,96,217,0.442,0.471,139,192,0.724,109,142,251,105,56,34,63,114,529
David Roddy,MEM,2718240.00,PF,21,70,4,1258,180,420,0.429,65,212,0.307,115,208,0.553,0.506,41,65,0.631,50,143,193,59,29,19,57,107,466
Isaiah Jackson,IND,2696280.00,C,21,63,12,1042,179,318,0.563,2,14,0.143,177,304,0.582,0.566,95,146,0.651,113,169,282,51,31,93,51,154,455
MarJon Beauchamp,MIL,2609400.00,SF,22,52,11,701,96,243,0.395,47,142,0.331,49,101,0.485,0.492,27,37,0.73,38,77,115,35,21,7,45,71,266
Charles Bassey,SAS,2600000.00,C,22,35,2,508,87,135,0.644,3,8,0.375,84,127,0.661,0.656,22,37,0.595,75,118,193,47,16,33,41,74,199
Kris Dunn,UTA,2586665.00,PG,28,22,3,568,116,216,0.537,17,36,0.472,99,180,0.55,0.576,41,53,0.774,9,91,100,124,25,10,35,58,290
Bruno Fernando,ATL,2581522.00,C,24,8,0,41,11,19,0.579,0,3,0,11,16,0.688,0.579,5,6,0.833,6,9,15,1,0,3,5,6,27
Damion Lee,PHO,2528233.00,SG,30,74,5,1506,200,452,0.442,110,247,0.445,90,205,0.439,0.564,94,104,0.904,39,186,225,99,30,7,78,118,604
Blake Wesley,SAS,2504640.00,SG,19,37,1,669,69,215,0.321,20,52,0.385,49,163,0.301,0.367,26,44,0.591,11,70,81,99,25,5,65,67,184
Wendell Moore Jr.,MIN,2421720.00,SG,21,29,2,153,18,43,0.419,2,17,0.118,16,26,0.615,0.442,4,5,0.8,4,14,18,18,8,5,8,13,42
Luke Kornet,BOS,2413304.00,C,27,69,0,804,113,170,0.665,3,13,0.231,110,157,0.701,0.674,32,39,0.821,86,111,197,53,11,46,25,81,261
John Konchar,MEM,2400000.00,SF,26,72,23,1494,138,320,0.431,60,177,0.339,78,143,0.545,0.525,28,36,0.778,64,246,310,100,77,25,37,112,364
Quentin Grimes,NYK,2385720.00,SG,22,71,66,2121,282,602,0.468,157,407,0.386,125,195,0.641,0.599,78,98,0.796,49,180,229,150,47,26,69,177,799
Nikola Jović,MIA,2352000.00,PF,19,15,8,204,28,69,0.406,8,35,0.229,20,34,0.588,0.464,18,19,0.947,9,22,31,10,7,2,10,19,82
JaVale McGee,DAL,4368030.00,C,35,42,7,355,80,125,0.64,2,5,0.4,78,120,0.65,0.648,24,41,0.585,30,77,107,11,4,26,36,54,186
Jordan McLaughlin,MIN,2320000.00,PG,26,43,0,678,61,145,0.421,24,78,0.308,37,67,0.552,0.503,15,18,0.833,15,47,62,148,32,4,33,28,161
Bones Hyland,LAC,2306400.00,PG,22,14,0,265,55,137,0.401,26,74,0.351,29,63,0.46,0.496,15,20,0.75,10,39,49,47,11,2,15,30,151
Peyton Watson,DEN,2303520.00,SG,20,23,2,186,29,59,0.492,6,14,0.429,23,45,0.511,0.542,11,20,0.55,8,29,37,11,2,11,8,14,75
Cam Thomas,BRK,2240160.00,SG,21,57,4,948,201,456,0.441,51,133,0.383,150,323,0.464,0.497,151,174,0.868,8,87,95,78,20,7,63,55,604
Vlatko Čančar,DEN,2234359.00,PF,25,60,9,889,108,227,0.476,43,115,0.374,65,112,0.58,0.57,38,41,0.927,24,104,128,80,22,14,37,84,297
Jaden Springer,PHI,2226240.00,SG,20,16,2,89,17,35,0.486,2,5,0.4,15,30,0.5,0.514,6,8,0.75,6,8,14,8,7,3,3,15,42
Day'Ron Sharpe,BRK,2210040.00,C,21,48,3,552,93,171,0.544,6,11,0.545,87,160,0.544,0.561,35,55,0.636,99,101,200,37,15,32,42,89,227
Santi Aldama,MEM,2194200.00,PF,22,77,20,1682,247,525,0.47,94,266,0.353,153,259,0.591,0.56,108,144,0.75,85,286,371,97,45,48,60,143,696
Andrew Nembhard,IND,2131905.00,SG,23,75,63,2073,284,644,0.441,92,263,0.35,192,381,0.504,0.512,49,62,0.79,35,164,199,341,70,13,126,179,709
Goga Bitadze,ORL,2066585.00,C,23,17,1,255,42,73,0.575,2,12,0.167,40,61,0.656,0.589,12,18,0.667,36,52,88,21,7,16,10,30,98
Luka Šamanić,UTA,2066585.00,PF,23,7,4,161,26,57,0.456,8,31,0.258,18,26,0.692,0.526,9,13,0.692,0,30,30,15,6,2,10,17,69
Taj Gibson,WAS,2019706.00,C,37,49,2,480,65,125,0.52,8,24,0.333,57,101,0.564,0.552,30,42,0.714,32,61,93,34,15,12,26,84,168
Sandro Mamukelashvili,SAS,2019706.00,C,23,19,7,443,78,172,0.453,23,67,0.343,55,105,0.524,0.52,27,39,0.692,52,77,129,46,10,7,26,33,206
Alex Len,SAC,2019706.00,C,29,26,2,161,16,30,0.533,0,2,0,16,28,0.571,0.533,11,16,0.688,24,36,60,12,4,11,16,28,43
Montrezl Harrell,PHI,2019706.00,C,29,57,7,681,125,209,0.598,0,6,0,125,203,0.616,0.598,70,101,0.693,67,92,159,33,17,25,35,75,320
Ryan Arcidiacono,NYK,2019706.00,PG,28,11,0,26,1,5,0.2,1,3,0.333,0,2,0,0.3,0,0,,0,4,4,2,2,0,1,3,3
Thanasis Antetokounmpo,MIL,2019706.00,PF,30,37,0,206,20,46,0.435,0,8,0,20,38,0.526,0.435,11,22,0.5,15,29,44,15,3,3,12,22,51
Jae Crowder,MIL,2019706.00,PF,32,18,3,340,45,94,0.479,24,55,0.436,21,39,0.538,0.606,10,12,0.833,17,52,69,27,12,6,7,27,124
DeAndre Jordan,DEN,2019706.00,C,34,39,8,586,88,115,0.765,1,1,1,87,114,0.763,0.77,22,48,0.458,52,150,202,34,12,23,48,71,199
Markieff Morris,DAL,2019706.00,PF,33,8,1,70,14,33,0.424,8,22,0.364,6,11,0.545,0.545,0,0,,0,12,12,6,1,0,4,15,36
Boban Marjanović,HOU,2019706.00,C,34,31,0,171,41,60,0.683,0,1,0,41,59,0.695,0.683,20,27,0.741,20,40,60,9,5,2,14,10,102
Terry Taylor,CHI,2019706.00,PF,23,5,0,36,9,10,0.9,1,1,1,8,9,0.889,0.95,1,4,0.25,5,3,8,0,0,1,0,2,20
Caleb Houstan,ORL,2000000.00,SF,20,51,4,812,66,182,0.363,46,136,0.338,20,46,0.435,0.489,15,18,0.833,34,65,99,30,12,7,18,63,193
Jaylin Williams,OKC,2000000.00,C,20,49,36,914,102,234,0.436,46,113,0.407,56,121,0.463,0.534,38,54,0.704,44,197,241,76,28,12,37,111,288
Garrison Mathews,ATL,2000000.00,SG,26,9,0,84,13,31,0.419,10,25,0.4,3,6,0.5,0.581,7,8,0.875,1,10,11,3,1,1,1,6,43
Anthony Gill,WAS,1997238.00,PF,30,59,8,624,71,132,0.538,4,29,0.138,67,103,0.65,0.553,49,67,0.731,37,62,99,34,7,12,15,70,195
Isaiah Joe,OKC,1997238.00,SG,23,73,10,1395,224,508,0.441,161,394,0.409,63,114,0.553,0.599,82,100,0.82,27,148,175,88,48,8,39,105,691
Sam Merrill,CLE,1997238.00,SG,26,5,0,59,9,22,0.409,5,18,0.278,4,4,1,0.523,2,2,1,0,9,9,5,4,0,0,3,25
Naji Marshall,NOP,1930681.00,SF,25,77,21,1792,247,571,0.433,66,218,0.303,181,353,0.513,0.49,138,175,0.789,48,231,279,189,54,14,97,113,698
Xavier Tillman Sr.,MEM,1930681.00,C,24,61,29,1180,188,306,0.614,4,15,0.267,184,291,0.632,0.621,49,89,0.551,121,186,307,96,58,29,44,97,429
Sam Hauser,BOS,1927896.00,SF,25,80,8,1290,180,396,0.455,140,335,0.418,40,61,0.656,0.631,12,17,0.706,35,169,204,71,29,21,30,99,512
Kessler Edwards,SAC,1927896.00,SF,22,22,3,306,30,69,0.435,15,43,0.349,15,26,0.577,0.543,10,13,0.769,17,30,47,21,11,5,9,37,85
Jericho Sims,NYK,1927896.00,C,24,52,16,812,83,107,0.776,0,1,0,83,106,0.783,0.776,12,16,0.75,99,143,242,25,15,28,27,96,178
Haywood Highsmith,MIA,1902137.00,PF,26,54,11,969,93,216,0.431,37,109,0.339,56,107,0.523,0.516,13,28,0.464,57,131,188,43,36,17,45,82,236
A.J. Green,MIL,1901769.00,SG,23,35,1,345,53,125,0.424,44,105,0.419,9,20,0.45,0.6,4,4,1,6,39,45,22,6,0,9,31,154
Miles McBride,NYK,1836096.00,PG,22,64,2,760,77,215,0.358,40,134,0.299,37,81,0.457,0.451,28,42,0.667,13,37,50,72,37,8,25,60,222
Brandon Boston Jr.,LAC,1836096.00,SF,21,22,1,248,51,122,0.418,12,29,0.414,39,93,0.419,0.467,29,38,0.763,7,23,30,20,9,0,12,21,143
Isaiah Livers,DET,1836096.00,PF,24,52,22,1199,120,288,0.417,74,203,0.365,46,85,0.541,0.545,32,39,0.821,28,115,143,41,28,28,30,103,346
Aaron Wiggins,OKC,1836096.00,SG,24,70,14,1297,186,363,0.512,48,122,0.393,138,241,0.573,0.579,59,71,0.831,68,142,210,80,39,15,55,110,479
Jose Alvarado,NOP,1836096.00,PG,24,61,10,1310,201,489,0.411,83,247,0.336,118,242,0.488,0.496,65,80,0.813,28,113,141,186,67,10,81,125,550
JT Thor,CHO,1836096.00,PF,20,69,8,969,95,238,0.399,39,123,0.317,56,115,0.487,0.481,33,47,0.702,36,116,152,36,22,23,44,66,262
Justin Minaya,POR,1801769.00,SF,23,4,0,89,7,23,0.304,3,12,0.25,4,11,0.364,0.37,0,1,0,3,12,15,4,2,5,4,9,17
Orlando Robinson,MIA,1801769.00,C,22,31,1,425,47,89,0.528,0,6,0,47,83,0.566,0.528,22,31,0.71,48,78,126,25,12,12,16,53,116
Stanley Umude,DET,1801769.00,SG,23,1,0,2,0,1,0,0,1,0,0,0,,0,2,2,1,0,0,0,0,1,1,0,0,2
Kennedy Chandler,MEM,1719864.00,PG,20,36,0,281,35,83,0.422,2,15,0.133,33,68,0.485,0.434,6,13,0.462,9,29,38,58,12,5,18,15,78
Jaden Hardy,DAL,1719864.00,SG,20,48,5,708,146,333,0.438,63,156,0.404,83,177,0.469,0.533,65,79,0.823,11,78,89,65,17,7,46,64,420
Xavier Cooks,WAS,1719864.00,PF,27,10,1,126,17,28,0.607,0,1,0,17,27,0.63,0.607,4,10,0.4,16,22,38,6,6,4,8,13,38
Christian Koloko,TOR,1719864.00,C,22,58,19,802,72,150,0.48,1,12,0.083,71,138,0.514,0.483,37,59,0.627,84,87,171,31,21,57,20,128,182
Josh Minott,MIN,1719864.00,SF,20,15,0,96,18,36,0.5,2,6,0.333,16,30,0.533,0.528,8,8,1,5,20,25,5,4,6,3,10,46
Kenneth Lofton Jr.,MEM,1719864.00,PF,20,24,1,176,49,93,0.527,6,17,0.353,43,76,0.566,0.559,16,27,0.593,19,32,51,20,5,2,12,28,120
Max Christie,LAL,1719864.00,SG,19,41,3,512,44,106,0.415,26,62,0.419,18,44,0.409,0.538,14,16,0.875,7,68,75,21,9,7,13,33,128
Bryce McGowens,CHO,1719864.00,SG,20,46,7,787,80,202,0.396,26,80,0.325,54,122,0.443,0.46,60,80,0.75,20,73,93,54,15,6,43,48,246
Jabari Walker,POR,1719864.00,SF,20,56,0,619,83,198,0.419,16,56,0.286,67,142,0.472,0.46,34,45,0.756,48,83,131,34,10,13,29,69,216
Neemias Queta,SAC,250000.00,C,23,5,0,29,6,9,0.667,0,0,,6,9,0.667,0.667,0,2,0,5,6,11,1,0,2,1,7,12
